NO ./textures/face3.xpm
SO ./textures/face2.xpm
WE ./textures/face1.xpm
EA ./textures/face0.xpm

F 66, 0, 0
C 224, 165, 159

111111111
110101001
1110S0101
111101111
111111111