NO ./textures/examples0.xpm
SO ./textures/examples1.xpm
WE ./textures/examples2.xpm
EA ./textures/examples3.xpm

F abc,10,45
C 255,30,0

111111111
100000001
1000000S1
111011111
