NO              ./textures/face3.xpm
SO                        ./textures/face2.xpm


                   WE                             ./textures/face1.xpm
EA                     ./textures/face0.xpm

               F 220,               100,                          0
C 225,                            30,                     0






111111111
100000001
1000000S1
111111111