NO ./textures/face3.xpm
SO ./textures/face2.xpm
WE ./textures/face1.xpm
EA ./textures/face0.xpm

F 1,0,0
C 225,30,0

 1
1S1
 1

                           1111111111
                        000000000
                 11111 111111111111

gros pouet